African sheepbush - Pentzia incana
Alder – Alnus
Black alder – Alnus glutinosa, Ilex verticillata
Common alder – Alnus glutinosa
False alder – Ilex verticillata
Gray alder – Alnus incana
Speckled alder – Alnus incana
White alder – Alnus incana, Alnus rhombifolia, Ilex verticillata
Almond – Prunus dulcis
Aloe vera – Aloe vera
Amaranth – Amaranthus
Foxtail amaranth – Amaranthus caudatus
Ambrosia
Tall ambrosia – Ambrosia trifida
Amy root – Apocynum cannabinum
Angel trumpet – Brugmansia suaveolens
Apple – Malus domestica
Apricot – Prunus armeniaca
Arfaj – Rhanterium epapposum
Arizona sycamore – Platanus wrighitii
Arrowwood – Cornus florida
Indian arrowwood – Cornus florida
Ash – Fraxinus spp.
Black ash – Acer negundo, Fraxinus nigra
Blue ash – Fraxinus quadrangulata
Cane ash – Fraxinus americana
European ash – Fraxinus excelsior[1]
Green ash – Fraxinus pennsylvanica lanceolata
Maple ash – Acer negundo
Red ash – Fraxinus pennsylvanica lanceolata
River ash – Fraxinus pennsylvanica
Swamp ash – Fraxinus pennsylvanica
White ash – Fraxinus americana
Water ash – Acer negundo, Fraxinus pennsylvanica
Azolla – Azolla
Carolina azolla – Azolla caroliniana